hoe gaat het?,hoe gaatie?=zaize?
film,bioscoop=kino
wachten=w88
wacht=w8
geen=n0,n0hh
probleem=probelm,rwina
lekker=lekkr,lekkurj,lekka
ding=dingj,dingetje
draaien=fixe,fixxoren,zetten
zeg=seg
kanker=kk,kenker,kenkr,kankr
beetje=beetjun,beetjuh
vader=ouwe,ouwes
boel=omin
sukkel,eikel,flikker,nub,noob,sukkl=kneus,sukkl,mogool,sukkl,mogol,sukeklt,hont,bezem,kabetti,joduhjong,a zemmel,zemmel,boelertje,attyboi,koelie,chiemboy,bezem,sultanliktir,ibne
jongens=kills
niet=niejt
misschien=miss
lelijk=leluk,tantoe leluk,omin lelijk
stoer=stien,gevarljik
gezeik=trobbi
moet=moett
cool,koel,vet,nice=spang,ait,vies,ziek
kusje=bossie
trek,trekje=offoe,snef,soetoe
huis=osso
jij=jy,juh
vrinden,vrienden=negers,matties,G's,niffu's,ouwes,brada's,dawgs,kills
toch=tok,tog
bij=bie
ops=fagget
maar=ma'
dat=dt,die
hij=hy,hji
straat=strattie,streets,block
leven=libbie
leuk=leuq
geld=monies,do
ban=ben
plaatje=pix,picx
stoned,dronken=stronken,stoened,stoned,wappie,skaffa,skafa,space
blut,geen geld=skeere tijden
politie,police=skootoe
school=skoro
elke=elleke
vies=faja
ruimte,klas=toko
gewoonte=steelo
normaal=standaard
schaam je=tfoe
sup,hallo,hoi,moge,mogge,goedemiddag,goedemorgen,hi,hey,jo,yo,yow,hai=Fakka G,Fakka,sup G,RUSTIG,RUSTIK,ewa,vrind,swa,G,jeweetzelf,faffie,faFFie,fawaka
best=bestt'
even=ff,effe
goed=vies,viez,spang
relaxed=spang
coffeeshop,koffieshop=shoppa
nee=n0mang,n0,n0p3,n0 mimang,neen,n33n
kus=kusj,kusJj,Kusjz :4
meisje,vrouw=bitch,chimeid,chimeisje,wijf,sletje,jailbait,hoer,kkhoer,chingmeid,sma
omdat=cuz,bcuz,cos
internet=intwerebs
xD,:p,:P,:D,:),:-),;-),=),(=,=],[=,^^=:PpPpPp,:$:$:$,:3:3:3:3,8')!!xD:$,:33:$:3:$PpPp,=3
irc=de straat,de block
moeder=moerr
krijg=kryg
cocaine=coca
met=meTj
je=jehh
verhaal,misdaad=torri
auto=waggie
ja=wollah,j4,wolla,j4 G,f0 sh0
bullshit,bs=leip,skeere tijden
voor=vo'
homo,mietje,faggot,fag,flikker,zemmel=a zemmel,zemmel,boelertje,attyboi,koelie,chiemboy,bezem,sultanliktir,maricon
gek=loessoe,para
schoenen=pattas
schoen=patta
pistool=pipa
aansteker=litta
metro=loco
mercedes=mercie
wat zei je?,wat?,wut?,pardon?,sorry?=wat praat jij mogool
veel=omin veel,tantoe veel
hetzelfde=hetzellufde
pop=poppi,poepie,shcatjuh
zijn=zijjn
leuke=leuqe
slecht=skeer,gierig,derie,faja, f0ked up G
grap=fatoe,fa2
grapje=fatoes,fa2s
grapjes=fatoes,fa2s
feest=fisa
script=scriptj3n,scr1ptj3n
amersfoort,utrecht,nijmegen,breda,eindhoven,maastricht,amsterdam,rotterdam,hilversum,apeldoorn,stad,alkmaar,almere,arnhem,groningen,friesland,pijnacker=kapoecity G
gewoon=gwoon
lol=whaha,wh3h4h4,xDxDxD,:pPpPpPpP,:D
zie=szie
coden,programmeren=hosselen,monie maken
trein=kktrein
lief,liefde,love=lobbi,lobi,luv,lovv
penis=peen0r,pe33n0r
me=muhh
bek=koulu bek
vandaag=vandaAgj
wiet=jonko,wiri
jonge=jongu
zogenaamd=zema
iedereen=iederen
rijden=boeken,boeke,boekuh
roken,blowen,drinken=roekend,smoken,sm0kuh,dringi
ruzie=fittie,rwina,paipai
ik=ick,iick,iiick,iek
onze=onzuhh
broer=brada,ab
van achteren=abakpoen
laatste,deel,helft=affoe
hasj=assie
neuken=baksen,batsen,knalle,ballen,boelen,dieken,pale,palen
10=donnie
25=chawa
50=bankoe
100=barki
1000=doezoe
praten=takki
hoofd=edde
imbiciel=ebbe
genieten=chillen,chillu,chille
nederlander,kaaskop=belanda
bmw=bempie
niks=nikz
vagina,kut=puni,punani
eten=nom nom
ok,oja=jeweet,jwt,jeweetzelluf,jeweetzelf,bam,je weetzzz,swaggon movement zoeken monie
zovaak=szovaakk
klas=klassie
gisteren=gisterjn
echt waar,ik zweer het,oja,echt?=wholla,whalla,wola
virus=dikke hax G
php=skeere php
wifi=skeere wifi
leraar=leroer
groot=biggie
muziek=pokoe
vriend,vrind=mattie,brada,G,mimang,mang,ouwe,mii bohh,niffu,dawg,player
begrijp het=mi saba
panasonic=pana
